NO ./texture/NO.xpm
SO ./texture/SO.xpm
WE ./texture/WE.xpm
EA ./texture/EA.xpm

F 220,100,0
C 0,0,255


111111111111111111111111111111111111111111111111111111
1000000000000000000S000000000000000000000000111111111
1111111111111111111111111111111111111111111111111111111
