NO ./texture/block.xpm
SO ./texture/block2.xpm
WE ./texture/minecraft.xpm
EA ./texture/odun.xpm

F 220,100,0
C 0,0,255

1111111111111111111111111111111111111111111111111111111
1111111110000000000000000000000000000000000000000010001
        10000000000000000000000000000000000000000000111111111
        100000000000000000000000000000000000000000001
1111111110000000000000000000000000000000000001111111
100000000000000000000000000000000000000000011
100000000000000000000000000000000000000000001
100000000000000000000000000000000000000000001
100000000000000000000000000000000000000000001
100000000000000000000000000000000000000000001
1000000000000000000111110000000000000000000001
100000000000000000000000000000000000000000001
10000000000000000000000N000000000000000000001
100000000000000000000000000000000000000000001
100000000000000000000000000000000000000000001
100000000000000000000000000000000000000000001
100000000000000000000000000000000000000000001
111111111111111111111111111111111111111111111
