NO ./texture/block.xpm
SO ./texture/block2.xpm
WE ./texture/minecraft.xpm
EA ./texture/odun.xpm

F 220,100,0
C 0,0,255

1111111111111111111111111111111111111111111111111111111
111111111111111111111111111111E111111111111111111111111
1111111111111111111111111111111111111111111111111111111
